Year,Location,Adults 19-25,Adults 26-34,Adults 35-54,Adults 55-64,Sum
2008,Alabama,429900,509400,1274800,531800,2745900
2008,Alaska,74100,79700,189300,78700,421800
2008,Arizona,572900,801300,1691800,669500,3735500
2008,Arkansas,250300,314800,763200,324000,1652300
2008,California,3619900,4515600,10346900,3643000,22125400
2008,Colorado,449500,636000,1442600,542100,3070200
2008,Connecticut,278400,346300,1060800,403800,2089300
2008,Delaware,76300,91700,242800,102100,512900
2008,District of Columbia,62300,90200,159200,64300,376000
2008,Florida,1527100,1927000,5022200,2121600,10597900
2008,Georgia,853400,1158000,2789300,994100,5794800
2008,Hawaii,117400,134000,347800,147400,746600
2008,Idaho,142700,180100,396700,166500,886000
2008,Illinois,1190900,1538400,3655400,1355500,7740200
2008,Indiana,532800,739300,1797900,701700,3771700
2008,Iowa,279600,311300,824500,340300,1755700
2008,Kansas,262700,316700,757100,303100,1639600
2008,Kentucky,348600,492200,1229700,498900,2569400
2008,Louisiana,432300,489200,1194900,494600,2611000
2008,Maine,95500,126800,403500,172600,798400
2008,Maryland,497500,618300,1668900,634000,3418700
2008,Massachusetts,566900,726200,1933600,741200,3967900
2008,Michigan,882400,1078700,2888600,1161400,6011100
2008,Minnesota,473900,598900,1528500,580700,3182000
2008,Mississippi,267900,315900,784100,317800,1685700
2008,Missouri,530500,667800,1643600,667500,3509400
2008,Montana,89300,99800,261500,119200,569800
2008,Nebraska,158800,203800,479100,190600,1032300
2008,Nevada,216400,328100,737000,290000,1571500
2008,New Hampshire,102300,134800,413300,164600,815000
2008,New Jersey,722400,938200,2639000,961700,5261300
2008,New Mexico,187700,225100,521300,221800,1155900
2008,New York,1805700,2199300,5657400,2195800,11858200
2008,North Carolina,757500,1052800,2622200,1042700,5475200
2008,North Dakota,73300,70100,161700,78000,383100
2008,Ohio,972400,1271300,3255800,1327800,6827300
2008,Oklahoma,334100,419400,947700,403900,2105100
2008,Oregon,333100,460300,1057200,468700,2319300
2008,Pennsylvania,1027600,1262900,3586200,1480700,7357400
2008,Rhode Island,98500,108400,309400,119800,636100
2008,South Carolina,385400,480700,1232800,540500,2639400
2008,South Dakota,65500,81600,217200,88600,452900
2008,Tennessee,518200,721300,1775000,733100,3747600
2008,Texas,2290300,3017100,6634500,2342700,14284600
2008,Utah,329200,378800,631800,223200,1563000
2008,Vermont,50100,60900,191000,81000,383000
2008,Virginia,658300,848000,2241100,875500,4622900
2008,Washington,551100,782300,1896300,772500,4002200
2008,West Virginia,148600,196900,514100,243700,1103300
2008,Wisconsin,501700,618700,1632800,646500,3399700
2008,Wyoming,48500,59600,146700,62900,317700
2008,Puerto Rico,392200,477800,1026300,444100,2340400
2009,Alabama,422600,531900,1266900,549200,2770600
2009,Alaska,68700,81300,194400,78200,422600
2009,Arizona,595200,831100,1696500,696300,3819100
2009,Arkansas,251000,328600,759600,334500,1673700
2009,California,3520400,4663300,10285600,3808600,22277900
2009,Colorado,460500,634800,1436300,566000,3097600
2009,Connecticut,286400,359300,1040900,416000,2102600
2009,Delaware,72700,102400,242700,105200,523000
2009,District of Columbia,60900,96300,160800,66000,384000
2009,Florida,1590600,2005000,4988100,2156700,10740400
2009,Georgia,874900,1169700,2764000,1021100,5829700
2009,Hawaii,104100,149400,338200,154400,746100
2009,Idaho,154200,174300,392500,172600,893600
2009,Illinois,1177900,1569600,3607400,1403300,7758200
2009,Indiana,570400,736500,1768000,726100,3801000
2009,Iowa,269600,329400,799100,352900,1751000
2009,Kansas,276600,315300,746100,312800,1650800
2009,Kentucky,374800,499000,1201400,509400,2584600
2009,Louisiana,440200,528800,1189200,501000,2659200
2009,Maine,101300,130100,387000,181800,800200
2009,Maryland,501200,639000,1660600,659500,3460300
2009,Massachusetts,565400,741200,1950900,774100,4031600
2009,Michigan,911100,1043700,2847200,1203600,6005600
2009,Minnesota,473800,622500,1499600,602400,3198300
2009,Mississippi,276000,331100,757500,321900,1686500
2009,Missouri,538100,673700,1638800,689300,3539900
2009,Montana,91100,103200,258000,128000,580300
2009,Nebraska,176300,206100,469400,197600,1049400
2009,Nevada,226400,340700,730600,292500,1590200
2009,New Hampshire,113100,127100,406000,168400,814600
2009,New Jersey,703500,964300,2597500,1000300,5265600
2009,New Mexico,189100,230200,512000,233000,1164300
2009,New York,1743600,2305400,5595600,2259500,11904100
2009,North Carolina,814400,1050100,2609800,1068900,5543200
2009,North Dakota,74500,69700,163900,73100,381200
2009,Ohio,971300,1290800,3240700,1376100,6878900
2009,Oklahoma,350400,419900,940200,408500,2119000
2009,Oregon,341500,465100,1038700,490000,2335300
2009,Pennsylvania,1039400,1340600,3543000,1532900,7455900
2009,Rhode Island,87300,118100,301400,125700,632500
2009,South Carolina,389000,508300,1226400,553800,2677500
2009,South Dakota,76500,88300,204700,96700,466200
2009,Tennessee,540000,730200,1754400,748200,3772800
2009,Texas,2355100,3132400,6628200,2407200,14522900
2009,Utah,329400,387900,638200,232400,1587900
2009,Vermont,57200,59800,179500,85000,381500
2009,Virginia,693900,881000,2215800,894100,4684800
2009,Washington,591200,812100,1875500,799400,4078200
2009,West Virginia,151700,197600,501400,247000,1097700
2009,Wisconsin,518600,623500,1606300,670400,3418800
2009,Wyoming,52100,63300,146400,67800,329600
2009,Puerto Rico,395600,477700,1035500,449200,2358000
2010,Alabama,436900,523500,1282300,587100,2829800
2010,Alaska,64000,85700,200000,85500,435200
2010,Arizona,582700,745100,1634700,727300,3689800
2010,Arkansas,258500,315400,766200,351300,1691400
2010,California,3693400,4633500,10298400,4035800,22661100
2010,Colorado,459100,628900,1419200,600200,3107400
2010,Connecticut,283000,361400,1048200,441700,2134300
2010,Delaware,80300,97400,244800,111100,533600
2010,District of Columbia,75500,106200,154100,62400,398200
2010,Florida,1639200,1947000,5089300,2334200,11009700
2010,Georgia,880400,1133400,2742600,1073300,5829700
2010,Hawaii,114800,142500,362300,175500,795100
2010,Idaho,145200,182700,394800,179100,901800
2010,Illinois,1144800,1561900,3559600,1469700,7736000
2010,Indiana,570800,725800,1766800,768200,3831600
2010,Iowa,267000,335900,801000,372300,1776200
2010,Kansas,257000,317700,745200,330200,1650100
2010,Kentucky,378400,490000,1195000,538600,2602000
2010,Louisiana,445500,533300,1189000,534300,2702100
2010,Maine,99000,129000,386000,192000,806000
2010,Maryland,511900,663600,1668100,694300,3537900
2010,Massachusetts,561800,743300,1887300,802600,3995000
2010,Michigan,872400,1021200,2764700,1251400,5909700
2010,Minnesota,447000,637300,1489000,634800,3208100
2010,Mississippi,265600,322000,776800,345600,1710000
2010,Missouri,533600,663900,1618400,718200,3534100
2010,Montana,80000,106400,260000,138500,584900
2010,Nebraska,162200,216300,475300,214200,1068000
2010,Nevada,241000,336900,747600,315500,1641000
2010,New Hampshire,99700,126400,402300,179800,808200
2010,New Jersey,706500,977300,2597600,1046800,5328200
2010,New Mexico,194100,222900,534900,257800,1209700
2010,New York,1794500,2323300,5440300,2302700,11860800
2010,North Carolina,818000,1072500,2652600,1133500,5676600
2010,North Dakota,69800,77900,171400,81500,400600
2010,Ohio,967400,1244400,3184200,1450700,6846700
2010,Oklahoma,335400,430900,970500,435000,2171800
2010,Oregon,337500,461600,1029600,512100,2340800
2010,Pennsylvania,1080100,1316200,3498500,1622900,7517700
2010,Rhode Island,98900,107200,296000,132300,634400
2010,South Carolina,418300,491500,1243400,584800,2738000
2010,South Dakota,71100,88500,209800,95600,465000
2010,Tennessee,543900,716400,1757800,783200,3801300
2010,Texas,2424400,3101500,6775200,2593400,14894500
2010,Utah,300900,395500,636400,239500,1572300
2010,Vermont,47700,62800,178900,90200,379600
2010,Virginia,689600,914000,2268000,957500,4829100
2010,Washington,599200,809300,1873700,838600,4120800
2010,West Virginia,151900,190500,501400,264000,1107800
2010,Wisconsin,501200,621300,1584300,702200,3409000
2010,Wyoming,51400,66400,148900,71900,338600
2010,Puerto Rico,363800,426900,967500,441000,2199200
2011,Alabama,441100,522000,1280100,604300,2847500
2011,Alaska,70700,88000,196500,90500,445700
2011,Arizona,602800,742400,1636700,752000,3733900
2011,Arkansas,253600,333800,757200,361300,1705900
2011,California,3760400,4685900,10286800,4187000,22920100
2011,Colorado,468700,645600,1419400,623300,3157000
2011,Connecticut,278500,370200,1033800,457400,2139900
2011,Delaware,76100,100200,244600,114500,535400
2011,District of Columbia,67600,119000,155000,65800,407400
2011,Florida,1682000,1990300,5061200,2410000,11143500
2011,Georgia,889400,1151000,2733400,1102900,5876700
2011,Hawaii,110900,155600,353600,178200,798300
2011,Idaho,145600,181700,396300,187100,910700
2011,Illinois,1159800,1560300,3516500,1521700,7758300
2011,Indiana,577200,720800,1744700,800100,3842800
2011,Iowa,264100,351600,781400,387700,1784800
2011,Kansas,265900,318200,735000,344500,1663600
2011,Kentucky,373400,490100,1184900,552700,2601100
2011,Louisiana,442200,542500,1180600,550400,2715700
2011,Maine,98700,129800,378500,197400,804400
2011,Maryland,511600,675200,1660700,721500,3569000
2011,Massachusetts,568300,746100,1869800,834600,4018800
2011,Michigan,913800,1019000,2703900,1294800,5931500
2011,Minnesota,460600,643700,1464300,654800,3223400
2011,Mississippi,271900,323100,774300,356600,1725900
2011,Missouri,522600,686500,1590600,748700,3548400
2011,Montana,91400,110000,253100,144500,599000
2011,Nebraska,170200,209200,471800,222500,1073700
2011,Nevada,245900,335400,746700,325800,1653800
2011,New Hampshire,104800,126600,394100,184900,810400
2011,New Jersey,717200,978400,2571100,1075800,5342500
2011,New Mexico,199600,232100,517200,266000,1214900
2011,New York,1833900,2357200,5391800,2367200,11950100
2011,North Carolina,830000,1078300,2642200,1177600,5728100
2011,North Dakota,75600,78800,167100,86200,407700
2011,Ohio,986700,1253500,3123800,1500900,6864900
2011,Oklahoma,337000,437900,960800,453300,2189000
2011,Oregon,347700,472100,1021800,524900,2366500
2011,Pennsylvania,1083200,1328700,3467600,1673400,7552900
2011,Rhode Island,98000,112000,290400,135600,636000
2011,South Carolina,421300,498300,1235400,603800,2758800
2011,South Dakota,71900,90600,205600,100400,468500
2011,Tennessee,560800,727000,1737600,813800,3839200
2011,Texas,2458500,3163000,6815100,2711200,15147800
2011,Utah,307700,392100,644900,255200,1599900
2011,Vermont,50500,61000,175900,93400,380800
2011,Virginia,710400,934000,2246800,984600,4875800
2011,Washington,613700,838600,1860100,872100,4184500
2011,West Virginia,158700,188400,494800,270500,1112400
2011,Wisconsin,499800,634500,1551600,734200,3420100
2011,Wyoming,51600,70100,144800,77100,343600
2011,Puerto Rico,366100,418900,957600,440100,2182700
2012,Alabama,447300,523500,1266800,609700,2847300
2012,Alaska,74800,91000,196000,94300,456100
2012,Arizona,603700,752300,1640500,756600,3753100
2012,Arkansas,261000,333200,751800,359400,1705400
2012,California,3818000,4742800,10290700,4261900,23113400
2012,Colorado,478600,652700,1409300,637000,3177600
2012,Connecticut,291300,368200,1018400,462500,2140400
2012,Delaware,83600,96900,242000,116100,538600
2012,District of Columbia,64100,123600,158400,66200,412300
2012,Florida,1706400,2052100,5075100,2445400,11279000
2012,Georgia,902800,1161700,2726600,1125300,5916400
2012,Hawaii,116300,162600,349300,179900,808100
2012,Idaho,148700,181300,396700,191700,918400
2012,Illinois,1170000,1564000,3486200,1541700,7761900
2012,Indiana,585800,733100,1721100,804600,3844600
2012,Iowa,276500,344400,777100,389000,1787000
2012,Kansas,263500,334400,723700,347800,1669400
2012,Kentucky,380600,488700,1174000,558300,2601600
2012,Louisiana,442400,551800,1168700,557200,2720100
2012,Maine,99000,131300,367300,200600,798200
2012,Maryland,514900,698100,1643700,733200,3589900
2012,Massachusetts,566500,775000,1849800,844800,4036100
2012,Michigan,922900,1016100,2654300,1316000,5909300
2012,Minnesota,441600,671300,1443600,680200,3236700
2012,Mississippi,281500,322600,751900,358400,1714400
2012,Missouri,527500,695700,1562600,753600,3539400
2012,Montana,85900,108900,255900,147200,597900
2012,Nebraska,158500,219000,471200,224900,1073600
2012,Nevada,250900,341700,749600,329500,1671700
2012,New Hampshire,104300,128600,385600,189600,808100
2012,New Jersey,723600,990200,2554700,1096500,5365000
2012,New Mexico,183200,241700,519800,264300,1209000
2012,New York,1839600,2395400,5333200,2405200,11973400
2012,North Carolina,850400,1076500,2654200,1188900,5770000
2012,North Dakota,75000,87000,168300,88400,418700
2012,Ohio,1003300,1250200,3073300,1517000,6843800
2012,Oklahoma,345800,441900,961800,455400,2204900
2012,Oregon,342500,473800,1022400,523900,2362600
2012,Pennsylvania,1112700,1358700,3386800,1702100,7560300
2012,Rhode Island,98400,114300,283400,135300,631400
2012,South Carolina,420600,512200,1227500,603800,2764100
2012,South Dakota,73100,95600,200700,108800,478200
2012,Tennessee,566500,726800,1729100,815700,3838100
2012,Texas,2501100,3236000,6872800,2772200,15382100
2012,Utah,316300,396300,656800,257800,1627200
2012,Vermont,52900,61900,168300,94300,377400
2012,Virginia,705400,964000,2242600,992800,4904800
2012,Washington,616800,849400,1862500,883700,4212400
2012,West Virginia,157100,190000,486400,272000,1105500
2012,Wisconsin,490900,642800,1538600,746200,3418500
2012,Wyoming,51700,72000,145000,78100,346800
2012,Puerto Rico,367400,402400,949500,437000,2156300
2013,Alabama,441800,533800,1246600,616200,2838400
2013,Alaska,75300,96000,186900,88900,447100
2013,Arizona,615800,771600,1631200,774200,3792800
2013,Arkansas,255500,337700,742800,363500,1699500
2013,California,3840800,4845800,10248700,4364000,23299300
2013,Colorado,484600,665600,1412000,649600,3211800
2013,Connecticut,286200,384800,994300,476200,2141500
2013,Delaware,78400,104800,243500,119100,545800
2013,District of Columbia,68800,126600,162500,67800,425700
2013,Florida,1704900,2089500,5056300,2491100,11341800
2013,Georgia,913100,1156600,2720800,1147000,5937500
2013,Hawaii,119600,160800,344100,176500,801000
2013,Idaho,147100,182600,394600,194600,918900
2013,Illinois,1185300,1565700,3450400,1573600,7775000
2013,Indiana,585600,734100,1709500,823500,3852700
2013,Iowa,272500,344600,770700,399800,1787600
2013,Kansas,262500,336000,710600,356300,1665400
2013,Kentucky,391900,484700,1160700,568600,2605900
2013,Louisiana,449500,562800,1156700,575900,2744900
2013,Maine,103600,129000,361100,204000,797700
2013,Maryland,510000,711200,1639800,746000,3607000
2013,Massachusetts,584200,786400,1827400,859900,4057900
2013,Michigan,929000,1028900,2604100,1343800,5905800
2013,Minnesota,462000,661400,1432400,690800,3246600
2013,Mississippi,278200,325300,750600,367600,1721700
2013,Missouri,546000,694700,1542600,769100,3552400
2013,Montana,90800,109700,246900,148200,595600
2013,Nebraska,169100,221900,460100,229600,1080700
2013,Nevada,250400,346900,750700,334900,1682900
2013,New Hampshire,104900,133000,375700,192300,805900
2013,New Jersey,734700,997000,2515200,1114900,5361800
2013,New Mexico,196600,234300,509100,265800,1205800
2013,New York,1843800,2443300,5292700,2441800,12021600
2013,North Carolina,869700,1082800,2633000,1210000,5795500
2013,North Dakota,86200,84500,170800,91200,432700
2013,Ohio,1004700,1271300,3023400,1539600,6839000
2013,Oklahoma,358600,454200,951400,458600,2222800
2013,Oregon,351200,466000,1023800,533700,2374700
2013,Pennsylvania,1095600,1381600,3338100,1726200,7541500
2013,Rhode Island,100100,116500,279300,139500,635400
2013,South Carolina,435700,516300,1225900,615200,2793100
2013,South Dakota,74200,97100,206200,109100,486600
2013,Tennessee,579300,732400,1720800,825000,3857500
2013,Texas,2550900,3294900,6904600,2844400,15594800
2013,Utah,312000,391200,674500,264900,1642600
2013,Vermont,47400,63800,167900,93900,373000
2013,Virginia,717100,973000,2229600,1013300,4933000
2013,Washington,621700,871200,1845600,891500,4230000
2013,West Virginia,155800,189900,480000,270900,1096600
2013,Wisconsin,497400,645700,1518000,761900,3423000
2013,Wyoming,55100,74100,140900,79600,349700
2013,Puerto Rico,362600,391700,935700,433600,2123600
2014,Alabama,443900,534100,1239200,626400,2843600
2014,Alaska,77000,92400,184700,92300,446400
2014,Arizona,629800,763700,1646800,786200,3826500
2014,Arkansas,255600,330800,742500,365900,1694800
2014,California,3847100,4986800,10292400,4478100,23604400
2014,Colorado,489100,695500,1411500,664200,3260300
2014,Connecticut,290500,382300,986300,482100,2141200
2014,Delaware,83900,101600,235800,123800,545100
2014,District of Columbia,64600,133100,168700,67800,434200
2014,Florida,1714600,2146800,5075100,2552600,11489100
2014,Georgia,923700,1180500,2723600,1162300,5990100
2014,Hawaii,116600,170100,344600,178500,809800
2014,Idaho,149600,182500,393200,198900,924200
2014,Illinois,1170100,1557900,3418400,1609800,7756200
2014,Indiana,593700,738200,1696100,831600,3859600
2014,Iowa,271000,349100,766600,401900,1788600
2014,Kansas,268100,335200,704100,358800,1666200
2014,Kentucky,387100,484100,1155200,573200,2599600
2014,Louisiana,441200,570000,1153600,578400,2743200
2014,Maine,102300,131500,354400,206600,794800
2014,Maryland,515800,719900,1628900,762500,3627100
2014,Massachusetts,597300,802700,1813900,877500,4091400
2014,Michigan,929600,1050300,2569200,1356200,5905300
2014,Minnesota,462200,678600,1416600,710400,3267800
2014,Mississippi,269800,323400,749000,368200,1710400
2014,Missouri,534800,703000,1530000,782700,3550500
2014,Montana,95200,110000,243000,149600,597800
2014,Nebraska,161900,223200,459800,233500,1078400
2014,Nevada,259200,351300,759100,342200,1711800
2014,New Hampshire,109400,132000,368000,196200,805600
2014,New Jersey,746900,1002000,2498000,1148200,5395100
2014,New Mexico,206800,233900,496900,270500,1208100
2014,New York,1828500,2487400,5265900,2478800,12060600
2014,North Carolina,872400,1097900,2640000,1232200,5842500
2014,North Dakota,83300,94700,168300,92200,438500
2014,Ohio,997400,1284600,2983500,1559200,6824700
2014,Oklahoma,361900,456000,947200,465100,2230200
2014,Oregon,340100,487200,1018900,538600,2384800
2014,Pennsylvania,1072200,1432100,3272400,1759700,7536400
2014,Rhode Island,96200,120400,275700,139900,632200
2014,South Carolina,423600,532700,1227900,626400,2810600
2014,South Dakota,77700,96500,200900,110100,485200
2014,Tennessee,593800,731500,1709900,839900,3875100
2014,Texas,2584900,3377300,7000600,2927300,15890100
2014,Utah,311100,391100,685900,277100,1665200
2014,Vermont,51100,64000,162600,95700,373400
2014,Virginia,733100,975000,2212600,1031700,4952400
2014,Washington,630600,881700,1845500,906500,4264300
2014,West Virginia,156300,189900,470100,266300,1082600
2014,Wisconsin,514100,644000,1493500,770200,3421800
2014,Wyoming,52600,73400,143900,81100,351000
2014,Puerto Rico,366000,373900,911700,432100,2083700
2016,Alabama,427300,541700,1220600,636800,2826400
2016,Alaska,72600,101200,179500,94000,447300
2016,Arizona,636200,796100,1664400,820100,3916800
2016,Arkansas,262600,328000,727600,373600,1691800
2016,California,3747200,5122900,10263600,4640800,23774500
2016,Colorado,502300,726700,1446200,691300,3366500
2016,Connecticut,305100,380800,942200,501300,2129400
2016,Delaware,74500,112000,233900,130700,551100
2016,District of Columbia,65800,135800,173900,69000,444500
2016,Florida,1706000,2277100,5140000,2699100,11822200
2016,Georgia,907900,1209700,2730400,1217700,6065700
2016,Hawaii,111500,168000,346000,183500,809000
2016,Idaho,146000,195400,398600,205300,945300
2016,Illinois,1125300,1560100,3333500,1638300,7657200
2016,Indiana,602900,738100,1655500,858200,3854700
2016,Iowa,276700,350500,761100,409900,1798200
2016,Kansas,271200,327000,697200,367100,1662500
2016,Kentucky,385100,485100,1129300,587300,2586800
2016,Louisiana,420200,569000,1143100,590300,2722600
2016,Maine,93200,137700,340300,208100,779300
2016,Maryland,496500,726500,1602300,784000,3609300
2016,Massachusetts,583400,836100,1775300,907200,4102000
2016,Michigan,909600,1092800,2486200,1384400,5873000
2016,Minnesota,456800,669100,1408200,733800,3267900
2016,Mississippi,272400,314900,735600,373000,1695900
2016,Missouri,514400,693200,1509500,807600,3524700
2016,Montana,93300,110000,242200,153400,598900
2016,Nebraska,172800,219500,461800,238400,1092500
2016,Nevada,256700,366500,769600,361500,1754300
2016,New Hampshire,106400,139200,352900,203600,802100
2016,New Jersey,743200,1007100,2429000,1182700,5362000
2016,New Mexico,188800,239800,492300,271200,1192100
2016,New York,1785100,2520400,5142900,2544000,11992400
2016,North Carolina,852900,1128500,2653200,1287900,5922500
2016,North Dakota,77400,98100,174800,95000,445300
2016,Ohio,982400,1307500,2891500,1594700,6776100
2016,Oklahoma,349300,464500,935700,482500,2232000
2016,Oregon,352400,509800,1034000,544500,2440700
2016,Pennsylvania,1043600,1465400,3173800,1789000,7471800
2016,Rhode Island,97300,121500,266800,146500,632100
2016,South Carolina,417000,555100,1231700,651200,2855000
2016,South Dakota,73500,102800,194500,114400,485200
2016,Tennessee,568700,764400,1710800,856600,3900500
2016,Texas,2623000,3540400,7108400,3078400,16350200
2016,Utah,323000,393900,714400,290000,1721300
2016,Vermont,50800,63700,156500,95100,366100
2016,Virginia,708400,976000,2195400,1072000,4951800
2016,Washington,635600,926300,1882200,940200,4384300
2016,West Virginia,152100,184800,459000,263800,1059700
2016,Wisconsin,504600,646600,1448700,807500,3407400
2016,Wyoming,50400,68800,139400,80400,339000
2016,Puerto Rico,335300,362600,872600,430800,2001300
2015,Alabama,424900,544800,1232300,631600,2833600
2015,Alaska,78800,96300,177800,92400,445300
2015,Arizona,631300,779700,1661800,804400,3877200
2015,Arkansas,259900,334700,738300,369900,1702800
2015,California,3816900,5070900,10311100,4590600,23789500
2015,Colorado,496000,723500,1421700,678500,3319700
2015,Connecticut,304000,376100,966000,493400,2139500
2015,Delaware,82200,105700,236900,126300,551100
2015,District of Columbia,66300,134800,171400,70600,443100
2015,Florida,1710900,2213200,5121000,2628500,11673600
2015,Georgia,914700,1184900,2741400,1201400,6042400
2015,Hawaii,120800,170400,342900,178900,813000
2015,Idaho,147900,186300,397600,202000,933800
2015,Illinois,1175400,1549800,3387900,1622000,7735100
2015,Indiana,607400,730400,1679100,844700,3861600
2015,Iowa,278600,348900,760100,410700,1798300
2015,Kansas,261900,334300,706000,365600,1667800
2015,Kentucky,385700,481200,1142800,584300,2594000
2015,Louisiana,434100,572700,1146300,588200,2741300
2015,Maine,103000,129600,347800,207900,788300
2015,Maryland,530000,709200,1618000,777100,3634300
2015,Massachusetts,595200,818300,1802900,903700,4120100
2015,Michigan,919100,1074100,2526500,1362100,5881800
2015,Minnesota,458100,671100,1421000,722700,3272900
2015,Mississippi,272600,315100,742700,370000,1700400
2015,Missouri,547100,685100,1514600,801300,3548100
2015,Montana,92600,114600,244200,150300,601700
2015,Nebraska,172100,218400,457900,236400,1084800
2015,Nevada,254900,359100,769200,351000,1734200
2015,New Hampshire,106600,135100,359400,201600,802700
2015,New Jersey,753700,1003000,2470200,1171400,5398300
2015,New Mexico,189400,236500,494500,269500,1189900
2015,New York,1822200,2503400,5223900,2518700,12068200
2015,North Carolina,871200,1119400,2634300,1258100,5883000
2015,North Dakota,78300,99100,174300,93900,445600
2015,Ohio,995900,1295600,2946300,1573500,6811300
2015,Oklahoma,343000,466300,942300,478700,2230300
2015,Oregon,350800,488300,1032500,542700,2414300
2015,Pennsylvania,1065700,1427900,3236200,1776400,7506200
2015,Rhode Island,97300,122000,271300,143900,634500
2015,South Carolina,444800,530600,1228900,637500,2841800
2015,South Dakota,73500,98500,199400,112500,483900
2015,Tennessee,581200,746800,1711000,850600,3889600
2015,Texas,2601500,3445000,7092600,3017900,16157000
2015,Utah,324800,385800,703900,280700,1695200
2015,Vermont,49800,67900,160100,97700,375500
2015,Virginia,720800,976000,2209100,1048700,4954600
2015,Washington,634300,912500,1857300,925400,4329500
2015,West Virginia,154300,185400,469500,267500,1076700
2015,Wisconsin,496800,642500,1486500,793800,3419600
2015,Wyoming,52200,70100,139000,80800,342100
2015,Puerto Rico,343900,365900,897000,428800,2035600
2017,Alabama,430500,536200,1207200,645600,2819500
2017,Alaska,63500,97900,183600,92400,437400
2017,Arizona,637200,815200,1677000,839900,3969300
2017,Arkansas,265200,329800,726600,377100,1698700
2017,California,3697900,5240600,10277900,4720500,23936900
2017,Colorado,492600,757900,1451700,697400,3399600
2017,Connecticut,297600,394900,927200,509500,2129200
2017,Delaware,78500,110500,231500,132900,553400
2017,District of Columbia,64200,141500,176600,68200,450500
2017,Florida,1698300,2330300,5217900,2777200,12023700
2017,Georgia,908000,1216400,2754900,1257200,6136500
2017,Hawaii,100400,169700,341900,182000,794000
2017,Idaho,150200,190100,410500,212000,962800
2017,Illinois,1114500,1554000,3288200,1654300,7611000
2017,Indiana,593900,753400,1651400,859000,3857700
2017,Iowa,273500,348700,753800,415400,1791400
2017,Kansas,263400,330000,687500,371900,1652800
2017,Kentucky,377400,492700,1119700,590100,2579900
2017,Louisiana,424700,551400,1139300,594900,2710300
2017,Maine,92500,143000,335100,209400,780000
2017,Maryland,500100,723100,1598700,807300,3629200
2017,Massachusetts,568000,863800,1765200,922400,4119400
2017,Michigan,896700,1111900,2462600,1393300,5864500
2017,Minnesota,463800,677000,1407900,744000,3292700
2017,Mississippi,273400,303900,731900,377300,1686500
2017,Missouri,510800,720200,1479400,813300,3523700
2017,Montana,95000,115500,246100,151200,607800
2017,Nebraska,167300,229600,453800,243500,1094200
2017,Nevada,257000,374200,788600,367700,1787500
2017,New Hampshire,104700,147400,345600,208300,806000
2017,New Jersey,734100,1026100,2420300,1207500,5388000
2017,New Mexico,191500,236800,481700,275600,1185600
2017,New York,1761000,2551200,5096700,2573500,11982400
2017,North Carolina,847500,1158700,2658600,1301900,5966700
2017,North Dakota,75100,98500,171900,97600,443100
2017,Ohio,987700,1331700,2860600,1600400,6780400
2017,Oklahoma,342600,463900,934700,486500,2227700
2017,Oregon,343700,524300,1051600,544500,2464100
2017,Pennsylvania,1028600,1466600,3152500,1796600,7444300
2017,Rhode Island,94600,126200,263400,146900,631100
2017,South Carolina,418700,554800,1246100,661400,2881000
2017,South Dakota,72000,104100,196700,114400,487200
2017,Tennessee,560900,791900,1706900,874700,3934400
2017,Texas,2612700,3587100,7243100,3155200,16598100
2017,Utah,325400,398900,736000,296800,1757100
2017,Vermont,52500,65500,151900,96300,366200
2017,Virginia,717900,983000,2188700,1079500,4969100
2017,Washington,628700,965900,1899400,949100,4443100
2017,West Virginia,148600,178300,448700,260600,1036200
2017,Wisconsin,495600,643300,1441400,812500,3392800
2017,Wyoming,48500,69400,133100,81500,332500
2017,Puerto Rico,327600,344300,849600,428200,1949700
2018,Alabama,419500,554400,1192600,646800,2813300
2018,Alaska,62200,93400,182800,94100,432500
2018,Arizona,645900,841100,1702900,862200,4052100
2018,Arkansas,255200,345400,722800,380200,1703600
2018,California,3594300,5299700,10212700,4737800,23844500
2018,Colorado,495000,771700,1471200,700700,3438600
2018,Connecticut,291600,387100,918600,510400,2107700
2018,Delaware,76700,109700,233100,134400,553900
2018,District of Columbia,64400,141400,179400,69900,455100
2018,Florida,1680500,2401900,5240300,2829800,12152500
2018,Georgia,901500,1262600,2743500,1268300,6175900
2018,Hawaii,98400,167600,340100,178500,784600
2018,Idaho,150600,203200,414500,212900,981200
2018,Illinois,1103100,1543200,3251000,1649800,7547100
2018,Indiana,585500,762900,1648200,865400,3862000
2018,Iowa,272000,352500,747900,411700,1784100
2018,Kansas,260300,325200,688300,371700,1645500
2018,Kentucky,388100,501600,1104200,591000,2584900
2018,Louisiana,408800,549800,1125800,592700,2677100
2018,Maine,93700,140400,332500,214300,780900
2018,Maryland,491800,712200,1573200,808400,3585600
2018,Massachusetts,581700,873100,1753300,936100,4144200
2018,Michigan,890600,1151100,2431200,1392900,5865800
2018,Minnesota,458400,685900,1398200,752600,3295100
2018,Mississippi,262100,326400,717600,377300,1683400
2018,Missouri,519900,714300,1470900,823200,3528300
2018,Montana,84500,118800,247800,152000,603100
2018,Nebraska,161600,224800,460200,242200,1088800
2018,Nevada,251100,386200,791200,373600,1802100
2018,New Hampshire,106400,146700,341300,212100,806500
2018,New Jersey,725800,1002400,2365900,1205500,5299600
2018,New Mexico,186400,239200,484500,271000,1181100
2018,New York,1648400,2552500,4945500,2573600,11720000
2018,North Carolina,848600,1179600,2653900,1330700,6012800
2018,North Dakota,78600,99300,170000,96800,444700
2018,Ohio,973600,1345900,2850100,1597400,6767000
2018,Oklahoma,333200,479300,932800,484900,2230200
2018,Oregon,347300,531100,1066100,539100,2483600
2018,Pennsylvania,1027000,1475100,3119700,1794800,7416600
2018,Rhode Island,92700,128900,262200,147700,631500
2018,South Carolina,423000,558000,1243300,673500,2897800
2018,South Dakota,77100,96400,200300,116700,490500
2018,Tennessee,571500,788700,1709100,884500,3953800
2018,Texas,2642800,3631000,7333600,3200800,16808200
2018,Utah,337300,403600,756700,298400,1796000
2018,Vermont,48400,68700,151600,95700,364400
2018,Virginia,702300,997000,2167600,1086400,4953300
2018,Washington,622000,1023700,1913600,955800,4515100
2018,West Virginia,143300,184300,443100,255300,1026000
2018,Wisconsin,489400,644200,1446800,817100,3397500
2018,Wyoming,46600,67500,136700,78800,329600
2018,Puerto Rico,304700,334200,812100,424600,1875600
2019,Alabama,414500,549500,1195300,645000,2804300
2019,Alaska,65300,97500,172900,92800,428500
2019,Arizona,656800,860500,1708100,877500,4102900
2019,Arkansas,253500,335600,723700,383200,1696000
2019,California,3539800,5288800,10152200,4751600,23732400
2019,Colorado,498900,792000,1488600,706600,3486100
2019,Connecticut,297800,390500,895300,510600,2094200
2019,Delaware,75900,111000,227200,135700,549800
2019,District of Columbia,60600,144700,180800,69200,455300
2019,Florida,1680200,2399400,5236000,2872900,12188500
2019,Georgia,917200,1252700,2744000,1284300,6198200
2019,Hawaii,96200,155600,342900,177500,772200
2019,Idaho,148300,210100,423000,218100,999500
2019,Illinois,1070400,1556300,3193400,1635400,7455500
2019,Indiana,593300,771600,1628100,870700,3863700
2019,Iowa,272600,349600,743900,416000,1782100
2019,Kansas,257400,324900,678500,368000,1628800
2019,Kentucky,383900,491400,1096100,592200,2563600
2019,Louisiana,393800,552100,1113600,593300,2652800
2019,Maine,97100,142900,328000,208900,776900
2019,Maryland,474900,720900,1559300,811700,3566800
2019,Massachusetts,581200,875600,1730600,935300,4122700
2019,Michigan,884100,1151600,2398300,1391200,5825200
2019,Minnesota,451900,690600,1387600,752800,3282900
2019,Mississippi,254000,315500,719900,376200,1665600
2019,Missouri,504400,721400,1462200,824200,3512200
2019,Montana,88300,118100,245200,149100,600700
2019,Nebraska,164300,229300,448800,241300,1083700
2019,Nevada,250700,396800,795100,381500,1824100
2019,New Hampshire,102700,150800,339100,213700,806300
2019,New Jersey,711700,1015000,2321300,1212800,5260800
2019,New Mexico,183500,238100,485800,269900,1177300
2019,New York,1632400,2537700,4850700,2579200,11600000
2019,North Carolina,870500,1192200,2635400,1345800,6043900
2019,North Dakota,74500,100400,169900,93200,438000
2019,Ohio,964100,1355100,2819400,1588300,6726900
2019,Oklahoma,349100,471600,927700,487600,2236000
2019,Oregon,347500,529800,1078300,532400,2488000
2019,Pennsylvania,976800,1520200,3071300,1790900,7359200
2019,Rhode Island,89100,129300,256900,150800,626100
2019,South Carolina,409100,578700,1241500,689000,2918300
2019,South Dakota,70100,98100,199900,115900,484000
2019,Tennessee,574000,820300,1687000,890200,3971500
2019,Texas,2647900,3687100,7375600,3233100,16943700
2019,Utah,342700,414800,764200,300000,1821700
2019,Vermont,51200,66400,147900,94400,359900
2019,Virginia,684600,981000,2165300,1104300,4935200
2019,Washington,619900,1028200,1926900,954000,4529000
2019,West Virginia,140600,182300,437000,254000,1013900
2019,Wisconsin,483000,658400,1423000,813700,3378100
2019,Wyoming,46800,65800,136100,75700,324400
2019,Puerto Rico,313200,331600,799900,426800,1871500
